Hot_Talking	BAT XYZ CAB BAT DEF CAB MAN DEF XYZ MAN
PostModern_Talking	XYZ MAN BAT XYZ CAB BAT DEF CAB MAN
Dumb_News	CAB DEF MAN XYZ BAT
Loud_Sports	XYZ BAT CAB DEF MAN
Hot_Show	MAN XYZ BAT CAB DEF
Hot_News	DEF MAN XYZ BAT
Loud_Show	DEF MAN XYZ BAT
Hourly_Sports	DEF DEF MAN XYZ BAT CAB
Almost_Talking	CAB BAT DEF CAB MAN DEF XYZ MAN BAT XYZ
Surreal_Games	CAB DEF MAN XYZ BAT
Cold_News	XYZ BAT CAB DEF MAN
Surreal_Talking	XYZ MAN BAT XYZ CAB BAT DEF CAB MAN
Cold_Sports	XYZ BAT CAB DEF
Cold_Talking	CAB MAN DEF XYZ MAN BAT XYZ CAB BAT DEF
Loud_Talking	DEF XYZ MAN BAT XYZ CAB BAT DEF CAB
Surreal_Cooking	MAN XYZ BAT CAB DEF
Almost_Sports	DEF MAN XYZ BAT CAB
PostModern_Sports	BAT CAB DEF MAN
Dumb_Games	DEF MAN XYZ BAT CAB
PostModern_Games	CAB DEF MAN XYZ BAT
Cold_Show	CAB DEF MAN XYZ
Surreal_Sports	BAT CAB DEF MAN XYZ
Hourly_Games	MAN XYZ BAT CAB DEF
Baked_Games	DEF MAN XYZ BAT CAB
Baked_Sports	CAB DEF MAN XYZ BAT
Surreal_Show	DEF MAN XYZ BAT CAB
PostModern_News	BAT CAB DEF MAN XYZ
Hourly_Show	XYZ BAT CAB DEF MAN
Cold_Cooking	DEF MAN XYZ BAT CAB
Almost_Show	XYZ BAT CAB DEF MAN
Loud_Games	CAB DEF MAN XYZ BAT
Baked_Cooking	BAT CAB DEF MAN
PostModern_Cooking	MAN XYZ BAT CAB DEF
Loud_Cooking	MAN XYZ BAT CAB DEF
Surreal_News	CAB DEF MAN XYZ
Almost_Cooking	CAB DEF MAN XYZ BAT
Loud_News	BAT CAB DEF MAN XYZ
Hourly_Talking	CAB BAT DEF CAB MAN DEF XYZ MAN BAT
Baked_Talking	BAT XYZ CAB BAT DEF CAB MAN DEF XYZ MAN
Almost_News	MAN XYZ BAT CAB DEF
PostModern_Show	DEF MAN XYZ BAT CAB
Hot_Sports	CAB DEF MAN XYZ BAT
Almost_Games	XYZ BAT CAB DEF
Hourly_News	MAN XYZ BAT CAB
Dumb_Cooking	XYZ BAT CAB DEF MAN
Hourly_Cooking	BAT CAB DEF MAN XYZ
Dumb_Sports	CAB DEF MAN XYZ
Baked_News	DEF MAN XYZ BAT
Hot_Games	DEF MAN XYZ BAT CAB
Dumb_Show	MAN XYZ BAT CAB
Dumb_Talking	MAN BAT XYZ CAB BAT DEF CAB MAN DEF XYZ
Hot_Cooking	XYZ BAT CAB DEF MAN
Cold_Games	BAT CAB DEF MAN XYZ
Baked_Show	MAN XYZ BAT CAB DEF
