Hot_Talking	BAT XYZ CAB BAT DEF CAB MAN DEF XYZ MAN CNO MAN NOX DEF MAN BOB DEF DEF XYZ CNO DEF
PostModern_Talking	XYZ MAN BAT XYZ CAB BAT DEF CAB MAN BOB NOX CNO MAN NOX DEF XYZ CNO DEF
Dumb_News	CAB DEF MAN XYZ BAT DEF BOB CNO CNO BAT
Loud_Sports	XYZ BAT CAB DEF MAN NOX MAN DEF CNO
Hot_Show	MAN XYZ BAT CAB DEF CNO NOX MAN ABC XYZ
Loud_Show	DEF MAN XYZ BAT DEF BOB CNO ABC
Hourly_Sports	DEF DEF MAN XYZ BAT CAB DEF BOB CNO NOX DEF DEF
Cold_Show	CAB DEF MAN XYZ MAN DEF BOB CNO XYZ DEF
Surreal_Games	CAB DEF MAN XYZ BAT DEF BOB CNO XYZ
Cold_News	XYZ BAT CAB DEF MAN NOX MAN DEF ABC
Surreal_Talking	XYZ MAN BAT XYZ CAB BAT DEF CAB MAN BOB NOX CNO MAN NOX DEF MAN DEF BAT CNO
Cold_Sports	XYZ BAT CAB DEF CNO NOX MAN BAT ABC
Dumb_Talking	MAN BAT XYZ CAB BAT DEF CAB MAN DEF XYZ CNO MAN NOX DEF MAN BOB ABC DEF XYZ
Cold_Talking	CAB MAN DEF XYZ MAN BAT XYZ CAB BAT DEF DEF CNO BOB NOX CNO MAN CNO DEF BAT CNO
Loud_Talking	DEF XYZ MAN BAT XYZ CAB BAT DEF CAB CNO BOB NOX CNO MAN NOX DEF DEF XYZ CNO
Surreal_Cooking	MAN XYZ BAT CAB DEF CNO NOX MAN CNO
Loud_Cooking	MAN XYZ BAT CAB DEF CNO NOX MAN XYZ DEF
PostModern_Sports	BAT CAB DEF MAN NOX MAN DEF BOB BAT
Dumb_Games	DEF MAN XYZ BAT CAB BOB CNO NOX BAT
PostModern_Games	CAB DEF MAN XYZ BAT DEF BOB CNO ABC XYZ
Surreal_Sports	BAT CAB DEF MAN XYZ MAN DEF BOB BAT ABC
Hourly_Games	MAN XYZ BAT CAB DEF CNO NOX MAN CNO BAT
Baked_Show	MAN XYZ BAT CAB DEF CNO NOX MAN XYZ
Baked_Games	DEF MAN XYZ BAT CAB BOB CNO NOX ABC XYZ
Baked_Sports	CAB DEF MAN XYZ BAT DEF BOB CNO BAT
Surreal_Show	DEF MAN XYZ BAT CAB BOB CNO NOX XYZ DEF
PostModern_News	BAT CAB DEF MAN XYZ MAN DEF BOB BAT ABC
Hourly_Show	XYZ BAT CAB DEF MAN NOX MAN DEF BAT ABC
Cold_Cooking	DEF MAN XYZ BAT CAB BOB CNO NOX CNO
Dumb_Sports	CAB DEF MAN XYZ MAN DEF BOB DEF CNO
Loud_Games	CAB DEF MAN XYZ BAT DEF BOB CNO BAT ABC
Dumb_Show	MAN XYZ BAT CAB BOB CNO NOX MAN BAT ABC
PostModern_Cooking	MAN XYZ BAT CAB DEF CNO NOX MAN DEF CNO
Almost_Talking	CAB BAT DEF CAB MAN DEF XYZ MAN BAT XYZ DEF MAN BOB DEF CNO BOB XYZ CNO DEF
Almost_News	MAN XYZ BAT CAB DEF CNO NOX MAN BAT ABC
Surreal_News	CAB DEF MAN XYZ MAN DEF BOB ABC XYZ
Almost_Cooking	CAB DEF MAN XYZ BAT MAN DEF BOB CNO DEF
Loud_News	BAT CAB DEF MAN XYZ MAN DEF BOB CNO BAT
Hourly_Talking	CAB BAT DEF CAB MAN DEF XYZ MAN BAT NOX DEF MAN BOB DEF CNO BOB XYZ ABC DEF
Baked_Talking	BAT XYZ CAB BAT DEF CAB MAN DEF XYZ MAN MAN NOX DEF MAN BOB DEF CNO DEF BAT
PostModern_Show	DEF MAN XYZ BAT CAB BOB CNO NOX XYZ
Hot_Sports	CAB DEF MAN XYZ BAT DEF BOB CNO CNO BAT
Hourly_News	MAN XYZ BAT CAB BOB CNO NOX CNO
Dumb_Cooking	XYZ BAT CAB DEF MAN NOX MAN DEF XYZ
Hourly_Cooking	BAT CAB DEF MAN XYZ MAN DEF BOB ABC XYZ
Almost_Sports	DEF MAN XYZ BAT CAB BOB CNO NOX CNO BAT
Almost_Show	XYZ BAT CAB DEF MAN NOX MAN DEF ABC XYZ
Baked_News	DEF MAN XYZ BAT DEF BOB CNO NOX BAT ABC
Hot_Games	DEF MAN XYZ BAT CAB BOB CNO NOX ABC
Baked_Cooking	BAT CAB DEF MAN NOX MAN DEF DEF CNO
Hot_News	DEF MAN XYZ BAT DEF BOB CNO NOX BAT
Hot_Cooking	XYZ BAT CAB DEF MAN NOX MAN DEF DEF
Cold_Games	BAT CAB DEF MAN XYZ MAN DEF BOB XYZ
Almost_Games	XYZ BAT CAB DEF CNO NOX MAN ABC
